NO textures/Walls/rock_wall_1.xpm
SO textures/Rocks/rock_wall_3.xpm
WE textures/Walls/wall_cracked_1.xpm
EA textures/Rocks/cobblestone.xpm


F 100,50,42
C 225,30,0


        1111111111111111111111111
        100000000011000001000001
        10110000011100001 100001
        100100000000000001000001
111111111011000001110000000000001
100000000011000001110111111111111
11110111111111011100000010001
11110111111111011101010010001
1100000011010101110000000001
1000000000000000000000010001
10000000000000000101010010001
11000001101010111111011110W0111
11110111 1110101 101111010001
11111111 1111111 111111111111
