   WE                            textures/wolfenstein/red_brick.xpm
NO      textures/wolfenstein/red_brick.xpm



SO textures/wolfenstein/red_brick.xpm

F      17,    38,     75

EA textures/wolfenstein/wood.xpm



C 218, 234, 235

1111111111111111111111111111
10E01100000000000000000000001
1000110000000011111100100001
100011000011110000011000111001
1000000000110000000000010000001
1110000000000011111111111111
1111111111111111111111111111






