   WE                            textures/wolfenstein/grey_stone.xpm
NO      text/Walls/wall_cracked_1.xpm



SO textures/wolfenstein/red_brick.xpm

F      17,    38,     64

EA textures/wolfenstein/wood.xpm



C 218, 234, 235

1111111111111111111111111
10E0110000000000000000001
1000110000000000111111001
1000110000100000110001001
1000000000000000000001001
1111111011111111111111111
1111111111111111111111111








