11111111111111
1010C000001001
10000C00000001
10001100E01001
10PC1100001001
11111111111111