1111111111111111
1000101011000001
100100001E000001
101P000001001001
100100000001C001
1000000000001001
1000000010000001
1000000010000001
1111111111111111