1111111111111111
1010101011000001
101100001E000001
101P000001001001
101100000001C001
1010000000001001
1010000010000001
1010000010000001
1111111111111111