1111111111111111
1000101010000001
100100000E000001
101P000000001001
100100001001C001
100000B1B1001001
1000000010000001
1000000010000001
1111111111111111