1111111111111111
1000101010000001
100100000E000001
101P000000001001
100100001001C001
1000000100001001
10000B0010000001
1000000010000001
1111111111111111